NO textures/quake_wall_1.xpm
SO textures/quake_wall_2.xpm
WE textures/quake_wall_3.xpm
EA textures/quake_wall_3.xpm

NO textures/42_single_switch.xpm
SO textures/42_wall.xpm
WE textures/42_switches.xpm
EA textures/42_single_switch.xpm

NO textures/purple_space_4.xpm
SO textures/purple_space_4.xpm
WE textures/purple_space_4.xpm
EA textures/purple_space_4.xpm

F 50, 50, 50
C 150, 150, 150

1111111111111111111111
1000000000000001000001
1000000000000000100001
1000000000000000011001
1000000000000000000101
1000000010000000000011
100000010100N110000001
1000000010000000000001
1000000000000000000001
1000000000000000000001
1011000110001100010001
1011000110001100010001
1011000110001100010001
1111111111111111111111