1111111111111111111111
1000000000000001000001
10000000000N0000100001
1000000000000000011001
1000000000000000000101
1000000000000000000011
1000000000000000000001
1000000000000000000001
1000000000000000000001
1000000000000000000001
1011000110001100010001
1011000110001100010001
1011000110001100010001
1111111111111111111111